%%%%%%%%%%%%%%%%%%%%%%%%%%%%
%                          %
%                          %
%                          %
%                          %
%                          %
%                          %
%                          %
%                          %
%                          %
%                          %
%                          %
%               GG         %
%                          %
%                          %
%                          %
%                          %
%                          %
%                          %
%                          %
%                          %
%                 P        %
%                          %
%                          %
%                          %
%                          %
%%%%%%%%%%%%%%%%%%%%%%%%%%%%
