%%%%%%%%%%%%%%%%%%%%%%%%%%%%
%                          %
%                          %
%                          %
%                          %
%                          %
%                          %
%                          %
%                          %
%                          %
%                          %
%                          %
%            GG GG         %
%                          %
%                          %
%                          %
%                          %
%                          %
%                          %
%                          %
%                          %
%                 P        %
%                          %
%                          %
%                          %
%                          %
%%%%%%%%%%%%%%%%%%%%%%%%%%%%
