%%%%%%%%%%%%%%%%%%%%%%%%%%%%%%%%%%%%%%%%%%%%%%%%%%%%%%%%%%%%%%%%%%%%%
%............%%............%%%       % % %%%%% %                  %%%
%.%%%%.%%%%%.%%.%%%%%.%%%%.%%%%%%%%%% % %                 %%%%%% %%%%
% %%%%.%%%%%.%%.%%%%%.%%%% %%%%%%%%%%%%%%%%%%%%%    %% % % % %%%% %%%
%.%%%%.%%%%%.%%.%%%%%.%%%%.%%  % % %%   % %  % % % % %%    % %%  % %%
%..........................%%%% %  %  %% % % %  %%%%%%%%%%%%%%%%%%%%%
%.%%%%.%%.%%%%%%%%.%%.%%%%.%%%%%%%%%%%%%%%  %%% % %       % %%      % 
%.%%%%.%%.%%%%%%%%.%%.%%%%.%                                        %
%......%%....%%....%%......%                                        %
%%%%%%.%%%%% %% %%%%%.%%%%%%                                        %
%%%%%%.%%%%% %% %%%%%.%%%%%%                                        %
%%%%%%.%            %.%%%%%%                                        %
%%%%%%.% %%%%  %%%% %.%%%%%%                                        %
%     .  %G  GG  G%  .     %                                        %
%%%%%%.% %%%%%%%%%% %.%%%%%%                                        %
%%%%%%.%            %.%%%%%%                                        %                                        
%%%%%%.% %%%%%%%%%% %.%%%%%%%                                       %
%............%%............%                                        %
%.%%%%.%%%%%.%%.%%%%%.%%%%.%                                        %
%.%%%%.%%%%%.%%.%%%%%.%%%%.%                                        %
% ..%%.......  .......%%.. %                                        %
%%%.%%.%%.%%%%%%%%.%%.%%.%%%                                        %
%%%.%%.%%.%%%%%%%%.%%.%%.%%%                                        %
%......%%....%%....%%......%                                        %
%.%%%%%%%%%%.%%.%%%%%%%%%%.%                                        %
%.............P............%                                        %
%%%%%%%%%%%%%%%%%%%%%%%%%%%%%%%%%%%%%%%%%%%%%%%%%%%%%%%%%%%%%%%%%%%%%                                       
